ticker,ev_ebit,roic,ev_ebit_rank,roic_rank,magic_formula
PSSA3,0.27,0.519,1,5,6
SYNE3,1.26,0.38,4,14,18
BRKM3,2.14,0.398,8,11,19
BRKM5,2.18,0.398,9,12,21
CMIN3,2.92,0.647,19,2,21
USIM3,1.55,0.342,5,20,25
GOAU3,0.96,0.317,2,23,25
VALE3,2.8,0.42,16,9,25
USIM5,1.64,0.342,6,21,27
GOAU4,1.06,0.317,3,24,27
ETER3,2.87,0.404,18,10,28
PLPL3,2.27,0.35,10,19,29
CSNA3,2.62,0.356,13,18,31
MRFG3,2.81,0.363,17,16,33
TASA3,3.89,0.514,29,6,35
AURA33,3.74,0.431,27,8,35
UNIP3,4.24,0.519,33,3,36
GGBR3,2.58,0.317,12,25,37
TASA4,3.94,0.514,30,7,37
UNIP6,4.47,0.519,39,4,43
GGBR4,3.2,0.317,21,26,47
AGRO3,3.94,0.318,31,22,53
FHER3,2.8,0.233,15,39,54
CRPG5,4.49,0.31,40,28,68
WIZS3,3.2,0.215,22,46,68
PETR4,3.61,0.216,26,44,70
LVTC3,3.56,0.213,25,47,72
PETR3,3.79,0.216,28,45,73
FESA4,5.0,0.312,47,27,74
LEVE3,4.88,0.282,45,30,75
RANI3,4.85,0.256,43,32,75
ALLD3,3.54,0.194,23,54,77
JALL3,5.69,0.254,52,33,85
JBSS3,4.64,0.212,42,49,91
CURY3,5.21,0.208,49,51,100
PTBL3,5.69,0.21,51,50,101
EUCA4,2.95,0.148,20,83,103
BEEF3,6.55,0.224,63,41,104
DEXP3,5.36,0.191,50,55,105
SAPR3,4.32,0.158,34,71,105
RAPT4,4.46,0.163,38,68,106
SAPR4,4.38,0.158,35,72,107
SAPR11,4.39,0.158,36,73,109
RSUL4,7.04,0.238,72,37,109
QUAL3,7.25,0.245,75,35,110
BRBI11,9.39,2.461,109,1,110
ALUP11,4.39,0.157,37,74,111
LAVV3,3.55,0.135,24,92,116
KEPL3,7.51,0.248,82,34,116
PARD3,6.81,0.207,67,53,120
PCAR3,2.08,0.116,7,116,123
JHSF3,4.86,0.151,44,80,124
BLAU3,9.61,0.36,111,17,128
CGAS5,9.03,0.263,104,31,135
ASAI3,8.32,0.224,97,42,139
ODPV3,10.97,0.373,125,15,140
TRPL4,6.07,0.142,54,87,141
PRIO3,9.79,0.302,113,29,142
CARD3,8.12,0.191,89,56,145
SLCE3,6.91,0.153,70,79,149
CAMB3,7.12,0.156,73,77,150
TAEE4,8.14,0.173,90,63,153
SUZB3,8.24,0.174,93,60,153
DMMO3,12.63,0.384,142,13,155
TAEE11,8.14,0.173,91,64,155
MOVI3,7.32,0.155,77,78,155
BTTL3,9.95,0.226,115,40,155
TECN3,4.63,0.116,41,115,156
TAEE3,8.23,0.173,92,65,157
CGRA4,6.13,0.126,56,103,159
KLBN4,8.82,0.174,102,59,161
ENAT3,7.36,0.148,79,84,163
SOJA3,10.8,0.218,122,43,165
NEOE3,6.08,0.119,55,112,167
KLBN11,9.06,0.174,106,61,167
TUPY3,6.46,0.123,61,106,167
ENBR3,6.32,0.118,58,113,171
EGIE3,9.04,0.173,105,66,171
ROMI3,6.86,0.126,68,104,172
PFRM3,4.0,0.095,32,140,172
CSMG3,6.41,0.115,59,117,176
KLBN3,10.07,0.174,116,62,178
EVEN3,2.31,0.068,11,168,179
DXCO3,8.47,0.151,98,81,179
COCE5,6.69,0.118,65,114,179
AMAR3,6.77,0.113,66,119,185
CMIG4,6.49,0.11,62,124,186
DMVF3,2.76,0.064,14,173,187
CPFE3,7.86,0.125,86,105,191
TGMA3,9.24,0.14,108,88,196
ENGI11,6.92,0.108,71,128,199
VITT3,13.29,0.208,147,52,199
POSI3,7.33,0.109,78,126,204
OFSA3,10.95,0.15,124,82,206
SIMH3,8.28,0.12,96,110,206
B3SA3,13.83,0.191,149,57,206
MYPK3,6.66,0.086,64,145,209
FIQE3,12.25,0.161,140,69,209
CIEL3,5.18,0.078,48,163,211
CLSC4,4.97,0.071,46,166,212
LCAM3,11.02,0.14,126,89,215
ABEV3,13.68,0.16,148,70,218
CMIG3,8.25,0.11,94,125,219
SHUL4,10.4,0.127,117,102,219
SMTO3,11.59,0.148,134,85,219
VBBR3,10.92,0.132,123,96,219
CPLE3,7.14,0.086,74,146,220
ECOR3,8.48,0.112,99,121,220
FRAS3,11.23,0.137,130,91,221
LPSB3,11.39,0.137,132,90,222
RENT3,16.62,0.177,164,58,222
CRFB3,10.49,0.123,118,107,225
PRNR3,7.93,0.098,88,138,226
TTEN3,14.25,0.157,152,75,227
DIRR3,6.42,0.071,60,167,227
FLRY3,11.3,0.131,131,97,228
CSED3,6.9,0.08,69,159,228
TFCO4,23.33,0.245,193,36,229
CPLE11,7.61,0.086,83,147,230
VULC3,11.7,0.133,135,95,230
MILS3,11.58,0.131,133,98,231
EQTL3,8.99,0.108,103,129,232
CPLE6,7.75,0.086,85,148,233
CBAV3,11.99,0.131,136,99,235
TOTS3,18.23,0.165,170,67,237
MELK3,6.31,0.052,57,182,239
VVEO3,11.13,0.12,128,111,239
SEER3,7.46,0.08,81,160,241
TIMS3,8.56,0.089,100,142,242
CESP6,8.27,0.085,95,150,245
CAML3,9.72,0.104,112,134,246
WEGE3,31.39,0.234,209,38,247
TRIS3,7.88,0.079,87,161,248
LREN3,13.88,0.13,150,100,250
LJQQ3,9.57,0.094,110,141,251
INTB3,28.65,0.213,203,48,251
MLAS3,9.86,0.096,114,139,253
GMAT3,12.95,0.122,144,109,253
MDNE3,5.81,0.036,53,202,255
VLID3,8.6,0.081,101,154,255
BOAS3,17.66,0.144,169,86,255
VIVA3,21.02,0.157,189,76,265
BMOB3,12.01,0.107,137,130,267
VAMO3,19.34,0.135,178,93,271
PORT3,12.22,0.106,139,133,272
SGPS3,7.75,0.045,84,191,275
GRND3,19.07,0.128,176,101,277
SBSP3,11.04,0.082,127,153,280
BRFS3,11.17,0.084,129,151,280
CYRE3,10.61,0.073,119,165,284
HYPE3,15.45,0.111,161,123,284
LIGT3,9.22,0.055,107,179,286
PDTC3,14.59,0.106,155,132,287
CCRO3,13.94,0.102,151,136,287
PGMN3,12.73,0.081,143,155,298
STBP3,16.63,0.102,165,135,300
ARZZ3,29.75,0.134,206,94,300
GETT3,7.28,0.011,76,226,302
LOGN3,19.25,0.109,177,127,304
GETT4,7.36,0.011,80,227,307
GGPS3,21.58,0.115,190,118,308
RAIZ4,15.4,0.083,160,152,312
ENEV3,18.34,0.088,171,143,314
NGRD3,13.2,0.066,146,170,316
RADL3,30.35,0.123,208,108,316
AERI3,26.19,0.112,199,122,321
POWE3,10.63,0.035,120,204,324
MTRE3,10.67,0.036,121,203,324
CTSA4,12.11,0.046,138,187,325
JSLG3,14.56,0.063,154,174,328
AGXY3,14.39,0.06,153,175,328
EZTC3,15.1,0.059,156,177,333
VIIA3,12.39,0.044,141,193,334
HAGA3,38.2,0.113,215,120,335
ALPA4,25.66,0.1,198,137,335
RRRP3,23.02,0.086,192,144,336
RDOR3,30.32,0.107,207,131,338
AMBP3,19.46,0.079,180,162,342
EMBR3,13.02,0.038,145,199,344
IGTI3,18.5,0.065,173,171,344
BRIT3,17.27,0.06,168,176,344
RECV3,20.95,0.081,188,157,345
CTSA3,15.3,0.046,158,188,346
YDUQ3,19.53,0.066,181,169,350
IGTI11,19.9,0.065,184,172,356
MDIA3,18.58,0.052,174,183,357
MRVE3,15.2,0.037,157,201,358
MULT3,23.46,0.074,195,164,359
BRML3,15.36,0.038,159,200,359
ALPK3,18.63,0.05,175,185,360
AZUL4,27.69,0.08,202,158,360
PETZ3,39.34,0.086,216,149,365
ESPA3,20.25,0.052,186,181,367
VIVT3,19.82,0.049,183,186,369
UGPA3,20.07,0.052,185,184,369
NTCO3,19.39,0.046,179,190,369
ALSO3,18.36,0.039,172,198,370
ELET6,16.3,0.031,162,209,371
ELET3,16.4,0.031,163,210,373
MOSI3,42.98,0.081,217,156,373
JPSA3,20.35,0.046,187,189,376
SBFG3,25.56,0.053,197,180,377
COGN3,17.22,0.027,167,212,379
HBRE3,16.67,0.024,166,215,381
CSAN3,22.07,0.045,191,192,383
EMAE4,24.39,0.039,196,196,392
ORVR3,47.53,0.057,218,178,396
RAIL3,29.1,0.041,204,194,398
AALR3,29.39,0.04,205,195,400
HBOR3,19.65,0.019,182,218,400
ANIM3,23.4,0.033,194,206,400
PNVL3,38.1,0.039,213,197,410
OPCT3,27.46,0.025,201,214,415
AMER3,34.15,0.035,210,205,415
BRPR3,27.42,0.021,200,217,417
LOGG3,35.39,0.023,211,216,427
SQIA3,60.3,0.032,220,207,427
SOMA3,47.65,0.029,219,211,430
GUAR3,35.91,0.018,212,219,431
GNDI3,91.13,0.031,227,208,435
ITSA4,72.65,0.017,223,220,443
APER3,67.49,0.017,221,222,443
GFSA3,38.14,0.01,214,230,444
HAPV3,172.28,0.027,231,213,444
ITSA3,73.68,0.017,224,221,445
AESB3,71.27,0.015,222,223,445
RCSL4,85.71,0.014,226,225,451
DASA3,110.98,0.01,228,229,457
RCSL3,307.16,0.014,234,224,458
TEND3,77.07,0.005,225,234,459
MEGA3,114.53,0.01,229,231,460
MGLU3,177.47,0.011,232,228,460
SEQL3,150.29,0.009,230,232,462
LWSA3,276.96,0.006,233,233,466
